


NO /Users/hbrahimi/goinfre/bluestone.png
SO /Users/hbrahimi/goinfre/purplestone.png
WE /Users/hbrahimi/goinfre/wood.png
EA /Users/hbrahimi/goinfre/sky_1.png
F 220,100,0
C 225,30,0


1111111111111111111
1000001001001000001
1011000001000001001
1001000001111101111
100000N000001000001
1000000000000000001
1000000000000000001
1111000000000001011
1000000001000000001
1111111111111111111